# # # # # # # # # # # # # # # # # # # # # # # # # # # #
# o o $ o o o o o o o o o # # o o o o $ o o o o o o o #
# o # # # # o # # # # # o # # o # # # # # o # # # # X #
# X #     # o #       # o # # o #       # o #     # o #
# o # # # # o # # # # # o # # o # # # # # o # # # # $ #
# o o o o o o o o $ o o o o o o o o o o o o o o o o o #
# o # # # # o # # o # # # # # # # # o # # o # # # # o #
# o # # # # o # # o # # # # # # # # o # # o # # # # o #
# o o o o o o # # o o o o # # o o o $ # # o $ o o o o #
# # # # # # $ # # # # #   # #   # # # # # o # # # # # #
#         # o # # # # #   # #   # # # # # o #         #
#         # o # #                     # # o #         #
#         # o # #   # #   # #   # #   # # o #         #
# # # # # # o # #   #             #   # # o # # # # # #
# o o o o o o       #   @         #       o o o o $ o #
# # # # # # o # #   #             #   # # o # # # # # #
#         # o # #   # # # # # # # #   # # o #         #
#         # o # #                     # # o #         #
#         # o # #   # # # # # # # #   # # o #         #
# # # # # # o # #   # # # # # # # #   # # o # # # # # #
# o o o o o o o o o o o o # # o o o o o o o o o o o o #
# o # # # # o # # # # # o # # o # # # # # o # # # # o #
# X # # # # o # # # # # o # # o # # # # # o # # # # o #
# $ o o # # o o o o o o o o o o o o o $ o o # # o o o #
# # # o # # o # # o # # # # # # # # o # # o # # o # # #
# # # o # # o # # o # # # # # # # # o # # o # # o # # #
# o o o o o o # # o o $ o # # o o o o # # X o o o o o #
# o # # # # # # # # # # o # # o # # # # # # # # # # o #
# o # # # # # # # # # # o # # o # # # # # # # # # # o #
# o o o $ o o o o o o o o o o o o o o o o o o o o o $ #
# # # # # # # # # # # # # # # # # # # # # # # # # # # #
